NO ./assets/textures/north.png
SO ./assets/textures/south.png
WE ./assets/textures/west.png
EA ./assets/textures/east.png

F 220,100,0
C 225,30,0

   111111111111111                        1111
   100000000000001                        1001
   1000000000111111111111111111111111111111001
   1000000000000010000000000000000000000000001
1111000000000000011111111111111111111111111111
100000000000101111
10000N000000001
100011110000001
10001  10000001
11111  11111111